10
0
00000000000000000000
00000000000000000000
00000000000000000000
00000000000000000000
00000111111111100000
00000100000000100000
00000100000000100000
00000100002000100000
00000100000000100000
00000100000000100000
00000111111111100000
00000000000000000000
00000000000000000000
00000000000000000000