10
8
00000000000000000000
00000000002000000000
00000000000000000000
00000000000000000000
00000111111111100000
00000100000000100000
00000100000000100000
00000100000000100000
00000100000000100000
00000100000000100000
00000111111111100000
00000000000000000000
00000000000000000000
00000000000000000000