0
0
0100201000000010000
0111001000000010000
0100001000000010000
0100111000010010011
0100001000010000000
0111001000010011100
0100001000010011100
0100000000010000000
0111111111111111101
0100000011100000000
0100111111111110000
0100001111111111100
0100001111111110000
0000000000000000000